1111111111111
1E0000C0000C1
1000011100001
1PC000000C001
1111111111111
