111111111111111
1000000E0000001
100C000000C0001
10000000P000001
1000000000C0001
111111111111111
