111111111111111
100000000000001
100C000000C0001
10000000P000001
1000000000C00E1
111111111111111
